-18
24
-9
10
0000000000000000000000000000000000000000000
1111111111111111111111111111111111111111110
0000000000000000000000000000000000000000000
0000000000000000000000000000000000000000000
0000000000000000000000000000000000000000000
0000000000000000000000000000000000000000000
0000000000000000000000000000000000000000000
0000000000000001111111100000000000000000000
0000000000100000111111100000000000000000000
0000000000000000111111100000000000000000000
0000000000010000111111100000000000000000000
0000000000000000111111100000000000000000000
0000000000000010111111100000000000000000000
0000000000000000111111100000000000000000000
0000000000000000000000000000000000000000000
0000000000000000000000000000000000000000000
0000000000000000000000000000000000000000000
0000000000000000000000000000000000000000000
0000000000000000000000000000000000000000000
0000000000000000000000000000000000000000000
