-8
5
-3
4
00000000000000
00000111111110
10000011111110
00000011111110
01000011111110
00000011111110
00001011111110
00000011111110
